; EASY 1

###P#########
# # #       #
# # ##### # #
#       # #D#
### ### # ###
# # #     # E
#   ####### #
# # #     # #
# # # # ### #
# # # #     #
# ### # ### #
#     # #   #
#############
